4 8
YAAAAAAA
AAAAAAAA
AAAAAABA
AAAAAAAA
8 8
BASSSAYY
AYSAYSAS
AAYYSYAS
SASAYAYY
SAASSSYS
SYYYSAAA
AYAASYSA
AKSYAYAA