4 8
YAYSSYAY
YSSYBAAA
KAYAAASY
AYSSYAYB
8 8
BASSSAYY
AYSAYSAS
AAYYSYAS
SASAYAYY
SAASSSYS
SYYYSAAA
AYAASYSA
AKSYAYAA
6 6
BSYYSA
YYAYAS
YYYKYY
YAYYSY
SAYAAS
SSSYYA


