8 8
BASSSAYY
AYSAYSAS
AAYYSYAS
SASAYAYY
SAASSSYS
SYYYSAAA
AYAASYSA
AKSYAYAA
4 8
YAYSSYAY
YSSYSBAA
KAYAAASY
AYSSYAYB