8 8
YASSSAYY
AYSAYSAS
AAYYSYAS
SASAYAYY
SAASSSYS
SYYYSAAA
AYAASYSA
ASSYAYAA